111111111111111111111111111
122222222222212222222222221
121111211111212111112111121
131111211111212111112111131
122222222222222222222222221
121111211211111112112111121
122222211222212222112222221
111111211111010111112111111
000001211111010111112100000
000001211000000000112100000
000001211011141110112100000
000001211011g0g110112100000
000001211011g0g110112100000
000001211011111110112100000
000001211000000000112100000
000001211111010111112100000
111111211011111110112111111
122222222222212222222222221
121111211111212111112111121
1322112222222p2222222112231
111211211211111112112112111
122222211222212222112222221
121111111111212111111111121
122222222222222222222222221
111111111111111111111111111

0: blank
1: wall
2: point
3: special point
4: gate
p: pacman(only one)
g: ghost(only four)